-9
11
-3
4
000000000000000000000
000000000000001111110
010000000000001111110
100000000000001111110
000000000000001111110
010000000000001111110
010000000000001111110
000000000000001111110
